Contents
1
How To Speak Giraffish
1.1
Colors
1.2
Shapes
1.3
Numbers
1.4
Days Of The Week
1.5
Months Of The Year
1.6
Seasons
1.7
Family Words
1.8
Fruits
1.9
Words
How To Speak Giraffish
[
]
Colors
[
]
Pink - Jionne
Red - Guiane
Green - Plitonah
Brown - Dakino
White - Blisy
Yellow - Dongali
Black - Yisicy
Purple - Sloonkan
Orange - Enjlang
Grey - Cisongal
Blue - Shinnahei
Shapes
[
]
Star - Pigalle
Circle - Shantanle
Rectangle - Gonad
Heart - Lolig
Triangle - Riggdun
Oval - Dingah
Square - Minieh
Numbers
[
]
Zero - Pinn
One - Ginn
Two - Liga
Three - Dalla
Four - Fiskan
Five - Quatiral
Six - Sikonn
Seven - Klene
Eight - Maga
Nine - Shooph
Ten - Ginnta
Eleven - Ginntaginn
Twelve - Ginntaliga
Thirteen - Ginntadalla
Fourteen - Ginntafiskan
Fifteen - Ginntaquatiral
Sixteen - Ginntasikonn
Seventeen - Ginntaklene
Eighteen - Ginntamaga
Nineteen - Ginntashopph
Twenty - Ligata
Thirty - Dallata
Forty - Fiskanta
Fifty - Quatiralta
Sixty - Sikonnta
Seventy - Kleneta
Eighty - Magata
Ninty - Shoophta
Hundred - Glopanhi
Thousand - Ginnsal
Million - Ligasal
Billion - Dallasal
For bigger illions, just use the number then tasal, so trillion = Dallatasal, as the tri in trillion is 3, quadrillion is Fiskantasal, etc.
Days Of The Week
[
]
Monday - Gronnlail
Tuesday - Salilail
Wednesday - Mealail
Thursday - Pontalail
Friday - Meabalail
Saturday - Kanalail
Sunday - Dalail
Day - Lail
Week - Shonab
Months Of The Year
[
]
January - Mitslig
February - Slotslig
March - Ginnslig
April - Ligaslig
May - Dallaslig
June - Fiskanslig
July - Quatiralslig
August - Sikonnslig
September - Kleneslig
October - Magaslig
November - Shoophslig
December - Talslig
Month - Slig
Year - Gautin
Seasons
[
]
Spring - Haulinge
Summer - Paulinge
Autumn - Haulouge
Winter - Paulouge
Family Words
[
]
Brother - Abaki
Sister - Abake
Sibling - Abako
Baby - Ching
Mother - Saedek
Father - Saedik
Parent - Saedok
Spouse - Glinock
Son - Plagui
Daughter - Plague
Child - Plaguo
Cousin - Glopa
Aunt - Glodek
Uncle - Glodic
Granny - Itisaedek
Grandpa - Itisaedik
Grandparent - Itisaedok
Granddaughter - Itiplague
Grandson - Itiplague
Grandchild - Plaguo
Fruits
[
]
Strawberry - Ginsin
Lemon - Lagar
Raspberry - Sipiksi
Cherry - Glopzhig
Grapes - Kongal
Pineapple - Pigitilo
Apple - Abecdi
Banana - Logirok
Words
[
]
Please=Termik
Thank you=Shilly
A=O
B=V
C=N
D=B
E=A
F=S
G=T
H=L
I=Y
J=Q
K=F
L=P
M=W
N=J
O=I
P=R
Q=C
R=X
S=K
T=Z
U=E
V=D
W=H
X=G
Y=U
Z=M
Giraffe - Tyxossa
Pig - Ryt
Chair - Nloyx
Planet - Rpojaz
Moon - Wiij
Sun - Kej
The - Zla
My - Wu
Mine - Wyja
Your - Uiex
You - Uie
Yours - Uiek
Me - Wa
Him - Lyw
His - Lyk
Her - Lax
Hers - Lak
Of - Is
And - Ojb
To - Zi
A - O
In - Yj
Language - Pojteota
Giraffish - Tyxossykl
English - Ajtpykl
That - Zloz
It - Yz
Is - Yk
Was - Hok