Nobezien
is a language derivate from English and Spanish. It was spoken throughout
FZR 1603
.
Words
[
]
Nobezien: Noviziska
Pencil: Perstezer
Eraser: Kojerle
Steam: Pushine
Engine: Salavre
Light: Lerteni
Dark: Verstiet
Universe: Frigyerzentia
Multiverse: Multerzentia
Galaxy: Retories
Omniverse: Omnizentia
Nobezia: Novizer
George: Iorgia
John: Ein
Mark: Margo
Samantha: Szamanda
Parent: Retervie
Father: Fadri
Brother: Vregyen
Family Tree: Ferzetsmarzia
Suffixes
[
]
-ia: sagy
-ation: bihn
-age: lend
Ious/Ous: fregh